6
35
S:W:1;0:W:1;0:W:1;0:W:1;0:W:3;0:W:2;
0:0:0;0:0:0;0:W:2;0:0:0;0:W:1;0:W:1;
0:0:0;0:0:0;0:0:0;0:W:2;0:W:1;0:W:2;
S:W:1;0:W:2;0:0:0;0:W:1;0:0:0;0:0:0;
0:0:0;0:W:1;0:0:0;0:W:2;0:W:2;0:0:0;
0:0:0;0:W:2;E:W:2;0:W:2;E:W:1;0:0:0;