7
30
0:W:2;0:W:1;0:W:1;0:W:1;0:W:3;0:W:1;0:W:2;
0:W:1;0:0:0;0:W:2;0:0:0;0:W:1;0:0:0;0:W:1;
0:W:3;0:0:0;0:0:0;0:W:2;0:0:0;0:0:0;0:W:1;
0:W:1;0:0:0;0:0:0;0:W:1;0:W:1;0:0:0;0:W:1;
S:W:2;0:0:0;0:L:2;0:L:1;0:L:1;0:L:2;0:W:1;
S:L:1;0:L:1;0:L:3;0:L:1;0:L:1;0:0:0;E:W:2;
0:0:0;0:L:1;0:L:2;0:L:1;0:L:1;0:L:1;E:L:1;