7
40
S:L:2;0:W:1;0:W:3;S:W:2;0:0:0;S:L:1;0:0:0;
0:L:1;0:W:2;0:W:2;0:0:0;0:0:0;0:L:2;E:L:1;
0:L:1;0:W:2;0:W:1;0:W:1;0:W:1;0:W:2;0:0:0;
0:L:2;0:L:1;0:L:2;0:W:1;0:W:1;0:W:1;0:0:0;
0:L:2;0:L:1;0:L:2;0:W:2;0:W:3;0:W:2;0:W:2;
E:L:2;0:W:2;0:W:2;0:0:0;0:0:0;0:0:0;0:W:1;
0:0:0;E:W:1;0:W:2;0:W:1;0:W:1;0:W:1;0:W:2;