8
18
0:0:0;0:0:0;0:0:0;0:W:2;0:0:0;0:0:0;0:0:0;0:0:0;
0:0:0;0:0:0;0:W:2;0:W:3;0:W:1;0:W:1;0:W:2;0:0:0;
0:0:0;0:W:2;0:W:2;0:W:1;0:0:0;0:0:0;0:W:1;0:0:0;
0:0:0;0:W:2;0:W:1;0:W:2;0:0:0;0:0:0;0:W:2;S:W:1;
0:0:0;0:W:2;0:W:1;0:W:4;0:W:1;0:W:1;0:W:1;0:0:0;
0:0:0;0:W:1;0:0:0;0:W:1;0:0:0;0:0:0;0:W:1;S:L:2;
0:W:2;0:W:2;0:0:0;0:W:2;0:W:1;0:W:3;0:W:2;0:L:1;
E:W:2;E:L:2;0:L:1;0:L:1;0:L:1;0:L:1;0:L:1;0:L:2;