6
15
S:L:1;0:L:1;0:L:1;0:L:1;0:L:3;0:L:2;
0:0:0;0:0:0;0:L:2;0:0:0;0:L:1;0:L:1;
0:0:0;0:0:0;0:0:0;0:L:2;0:L:1;0:L:2;
0:0:0;0:0:0;0:0:0;0:L:1;0:0:0;0:0:0;
0:0:0;0:0:0;0:0:0;0:L:2;0:L:2;0:0:0;
0:0:0;0:0:0;0:0:0;0:L:2;E:L:1;0:0:0;