10
15
0:0,0:0,0:2,S:2,0:0,0:0,0:0,0:0,0:0,0:0,
0:0,0:0,0:1,0:0,0:0,0:0,0:0,0:0,0:0,0:0,
0:0,0:0,0:3,0:1,0:2,0:0,0:0,0:0,0:0,0:0,
E:2,0:2,0:2,0:0,0:1,0:0,0:0,0:0,0:0,0:0,
0:2,0:2,0:0,0:0,0:1,0:0,0:0,0:0,0:0,0:0,
0:0,0:0,0:0,0:0,0:1,0:0,0:0,0:0,0:0,0:0,
0:0,0:0,0:0,0:2,0:4,0:2,0:0,0:0,0:0,0:0,
0:0,0:0,0:0,0:1,0:1,0:1,0:0,0:0,0:0,0:0,
0:0,0:0,0:0,0:1,0:1,0:1,0:0,0:0,0:0,0:0,
0:0,0:0,0:0,0:2,0:3,0:3,0:1,0:1,E:2,0:0,