10
20
0:0,0:0,0:0,0:0,0:0,0:0,0:0,0:0,0:0,0:0,
S:1,0:2,0:0,0:0,0:0,0:0,0:0,0:0,0:0,0:0,
0:0,0:1,0:0,0:0,0:2,0:1,0:2,0:0,0:0,0:0,
0:0,0:1,0:0,0:0,0:1,0:0,0:1,0:0,0:0,0:0,
0:0,0:2,0:1,0:1,0:3,0:0,0:1,0:0,0:0,0:0,
0:0,0:0,0:0,0:0,0:1,0:0,0:1,0:0,0:0,0:0,
0:0,0:0,0:0,0:0,0:2,0:1,0:4,0:1,0:3,E:1,
0:0,0:0,0:0,0:0,0:0,0:0,0:1,0:0,0:1,0:0,
0:0,0:0,0:0,0:0,0:0,0:0,0:2,0:1,0:2,0:0,
0:0,0:0,0:0,0:0,0:0,0:0,0:0,0:0,0:0,0:0,