8
18
0:0;0:0;0:0;0:2;0:0;0:0;0:0;0:0;
0:0;0:0;0:2;0:3;0:1;0:1;0:2;0:0;
0:0;0:2;0:2;0:1;0:0;0:0;0:1;0:0;
0:0;0:2;0:1;0:2;0:0;0:0;0:2;E:1;
0:0;0:2;0:1;0:4;0:1;0:1;0:1;0:0;
0:0;0:1;0:0;0:1;0:0;0:0;0:1;0:0;
0:2;0:2;0:0;0:2;0:1;0:3;0:2;0:0;
S:2;0:0;0:0;0:0;0:0;0:0;0:0;0:0;